##################################################################################
#              #                    ##  #                                       ##
#              #                     ## #                                       ##
#          #   #                      ###  #########                         #  ##
#          #   #                       ##  #       #                         #  ##
#          #   #                        #  #       #                         #  ##
#          #   #                        #  #    #  #                         #  ##
#          #   #                        #  ######  #                         #  ##
#          #   #                        #          #                         #  ##
#   ########   #                        #          #                         #  ##
#   #      #   #                        ############                         #  ##
#   #      #   #                                                             #  ##
#   #      #   #                                                             #  ##
#   #      #   #                        #                                    #  ##
#   #      #   #                        #                                    #  ##
#   #      #   #                                                             #  ##
#   #      #   #                                                             #  ##
#   #      #   #                        #                                    #  ##
#   #      #   #                        #                          ####      #  ##
#   #      #                                                          #      #  ##
#   #      #          #                                   #           #      #  ##
#   #      #                            #                             #      #  ##
#   #      #####                        #                          #  #      #  ##
#   #                                                              #  #      #  ##
#   #                                                              #  #      #  ##
#   #                                   #                          #  #      #  ##
#   #                                   #                          #  #      #  ##
#   #                                                              #  #      #  ##
#   #                                                              #  #      #  ##
#   #                        ############                          #  #      #  ##
#   #                        #          #                          #  #      #  ##
#   #                        #          #                          #  ########  ##
#   #                        #  ######  #                          #  #         ##
#   #                        #  #    #  #                          #  #         ##
#   #                        #  #    #  #                          #  #         ##
#   #                        #       #  #                          #  #         ##
#   #                        #       #  ##                         #  #         ##
#                            #########  ###                        #  #         ##
#                                       # ##                       #            ##
#                                       #  ##                      #            ##
##################################################################################
