#################################################################################
#                                  #                    #                 #     #
#                                  #  # #                #           #        # #
#                    #          #                            #         #     # ##
#             #    # #        #      #  #        #     ##         #       #     #
#               #               #                        #           # #     #  #
# #                # #   #        #     #                                  ##   #
#       #                          ##          # #                              #
#    # #  #                          #   #  # # #     #                         #
## #       #  #      #                #  #                        ##   #        #
##                   #               #                ##              #   #     #
#         #                     #   # ##                    # #              #  #
#     #         # # #       #  #                     ## ##                      #
#      #             #    #            #                                   ##   #
##                                              #      #                #     # #
# #                          #           #      #       #      ##               #
#        # ##             #                           #     #     ## #          #
#       #                             #  #      # #     #                    #  #
#                    #        #                           #                  #  #
#       #                         #                   #             #        #  #
#   #       #         #            #                    #       #               #
#                             #         #                                       #
#        #                    #           #   #                        #   #   ##
# #        #   #                                        #    ##          # #    #
#                 #          #                #         #             #         #
#     #  #             #               #           ## #    #  #             #   #
#                       # #                   #                           #     #
#                              #              #        #                     #  #
##            #  #                #          #         #             # #    #   #
# #                         ##                       #                          #
#            #                                                      # #         #
##         #                             #             #                   #    #
#                   #             #   #   #      #            #       #       # #
# #                #   ##                        #                   #          #
##    #  #             #     #   #                                 # #          #
#      #   # #         #   #            #     #      # #        #               #
#               #                   # #   # #                     #             #
#                               #    #   #        #                 #           #
#     #                              #       #           #                      #
#  #                #                           # #  #        #            # #  #
#################################################################################