#################################################################################
#       #                                                                       #
#       #                                                                       #
#       #                                                                       #
#       #                                                                       #
#       #                                                                       #
#       #                                                                       #
#       #                                                                       #
#   #####                                                                       #
#   #                                                                           #
#   #                                                                           #
#   #                                                                           #
#   #                                                                           #
#   #                                                                           #
#   #                                                                           #
#   #                                                                           #
#   #                                    #                                      #
#   #                                                                           #
#   #                                                                           #
#   ##                                                                          #
#    ##                                                                         #
#     ##                                                                        #
#      ##                                                                       #
#       ##                                                                      #
#        #                                                                      #
#                                                                               #
#                                                                               #
##########                                                                      #
#        #                                                                      #
#        #                                                                      #
#        #                                                                      #
#        #                                                                      #
#        #                                                                      #
#        #                                                               ########
#        #                                                               ########
#        #                                                               ########
#        #                                                               ########
#        #                                                               ########
#        #                                                               ########
#        #                                                               ########
#################################################################################
